I 0 3 0 0 1 0 180 0 
I 8 3 0 6 1 0 0 0 
I 8 3 1 6 1 0 0 0 
I 8 3 0 5 1 0 0 0 
I 8 3 1 5 1 0 0 0 
I 1 3 2 6 1 0 0 0 
I 5 3 2 5 1 0 180 0 
I 8 3 0 5 2 0 0 0 
I 8 3 0 4 2 0 0 0 
I 4 3 0 2 1 0 0 0 
I 6 3 0 1 1 0 0 0 
C 5 2
C 6 2
C 7 2
C 8 1
