I 0 0 0 0 0 0 180 0 
I 8 6 0 6 2 0 0 0 
I 8 6 1 6 2 0 0 0 
I 1 6 2 6 2 0 0 0 
I 8 6 0 6 1 0 0 0 
I 8 6 1 6 1 0 0 0 
I 8 6 0 5 1 0 0 0 
I 7 0 0 1 0 0 90 0 
I 8 3 0 3 1 0 0 0 
I 4 3 1 3 1 0 0 0 
C 2 20
C 3 6
C 4 2
C 5 6
C 6 6
C 7 4
C 8 6
